{
    "worldId": 2,
    "data": [
        [0,0,0,0,0,1,1,1],
        [0,3,0,0,0,0,0,1],
        [0,0,0,0,0,0,0,1],
        [1,1,1,0,0,0,0,0],
        [0,0,0,0,0,0,0,0],
        [1,0,2,0,0,0,0,0],
        [1,0,0,0,0,0,0,0],
        [1,1,1,0,0,0,0,0]
    ],
    "_comment": "0: empty, 1: wall, 2: player, 3: goal"
}