{
    "worldId": 4,
    "data": [
        [2,0,0,0,0,0,0,0],
        [1,1,1,0,1,1,1,0],
        [0,0,0,0,1,0,1,0],
        [1,1,0,1,1,0,0,0],
        [0,0,0,1,1,1,1,1],
        [0,1,1,1,0,0,0,0],
        [0,1,1,1,0,1,1,0],
        [0,0,0,0,0,1,1,3]
    ],
    "_comment": "0: empty, 1: wall, 2: player, 3: goal, 4: pointer, 5: win"
}